-2,-2,5,5,0,0,-3,5,5,-3,-3
-2,-2,5,5,0,-3,0,5,5,-3,-3
5,5,5,5,0,-3,0,5,5,5,5
5,5,5,5,0,-3,0,5,5,5,5
-2,0,0,0,0,-3,0,0,0,0,0
0,-2,-2,-2,-2,5,-4,-4,-4,-4,0
0,0,0,0,0,-1,0,0,0,0,-4
5,5,5,5,0,-1,0,5,5,5,5
5,5,5,5,0,-1,0,5,5,5,5
-1,-1,5,5,0,-1,0,5,5,-4,-4
-1,-1,5,5,-1,0,0,5,5,-4,-4